0 0 0 5 100 5 100 0
0 0 0 100 5 100 5 0
0 95 0 100 100 100 100 95
95 0 95 100 100 100 100 0
20 20 20 25 30 25 30 20
60 60 60 75 75 75 